\n
\n
\n
NO ./path_to_the_north_texture\n
\n
\n
\n
\n
\n
SO ./path_to_the_south_texture\n
WE ./path_to_the_west_texture\n
\n
\n
\n
\n
\n
EA ./path_to_the_east_texture\n
\n
\n
\n
F 220,100,0\n
\n
\n
\n
\n
C 255,255,255\n
\n
\n
\n
\n
\n
\n
\n
Batatnhia qufshdafsdlfsadk \n
100000000000000000000000001\n
1000000N0000000000000000001\n
111111111111111111111111111\n
\n
\n
\n