NO ./texture/north.png
SO ./texture/south.png
WE ./texture/west.png
EA ./texture/east.png

F 0,0,1
C 255,255,255

111111111111111111111111111
100000000000000000000000001
1000000S0000000000000111111
100000000000001111000000011
10000000000001    100000101
100000000000001111100000001
100000000000000000000000001
111111111111111111111111111




