

NO ./texture/north.png


SO ./texture/south.png


WE ./texture/west.png
EA ./texture/east.png


F 0,0,0

C 255,255,255





111111111111111111111111111
100000000000000000000000001
1000000N0000000000000000001
111111111111111111111111111



