

NO ./texture/north.png


SO ./texture/south.png


WE ./texture/west.png
EA ./texture/east.png


F 0,0,1

C 255,255,255





111111111111111111111111111
100000000000000000000000001
100000000000100000000000001
10000000W000000000000000001
100000000000001000000000001
100000000000000000000000001
100000000000000000000000001
111111111111111111111111111



