NO ./texture/north.png
SO ./texture/south.png
WE ./texture/west.png
EA ./texture/east.png

F 220,100,0
C 225,30,0




1111111111111111111111111
100000S000110000000000001
1011000001110000000000001
1001000000000000000111101
100100000000000000111$
10010000000000000001
10010000000000000000101
1001000000000000000000111
100100000000000000000001
1111111111111111111111111






