NO ./texture/north.png
SO ./texture/south.png
WE ./texture/west.png
EA ./texture/east.png
F 220,100,0
C 225,30,0

1111111111111111111111111
10000000001100000000000N1
1011000001110000000000001
1001000000000000000000001
1001000000000000000000001
1001000000000000000000001
1001000000000000000000001
1001000000000000000000001
1001000000000000000000001
1111111111111111111111111
